Achromobacter_spp.	nusA,rpoB,eno,gltB,lepA,nuoL,nrdA
Acinetobacter_baumannii#1	Oxf_gltA,Oxf_gyrB,Oxf_gdhB,Oxf_recA,Oxf_cpn60,Oxf_gpi,Oxf_rpoD
Acinetobacter_baumannii#2	Pas_cpn60,Pas_fusA,Pas_gltA,Pas_pyrG,Pas_recA,Pas_rplB,Pas_rpoB
Aeromonas_spp.	gyrB,groL,gltA,metG,ppsA,recA
Aggregatibacter_actinomycetemcomitans	adk,atpG,frdB,mdh,pgi,recA,zwf
Anaplasma_phagocytophilum	pheS,glyA,fumC,mdh,sucA,dnaN,atpA
Arcobacter_spp.	aspA,atpA,glnA,gltA,glyA,pgm,tkt
Aspergillus_fumigatus	ANX4,BGT1,CAT1,LIP,MAT1_2,SODB,ZRF2
Bacillus_cereus	glp,gmk,ilv,pta,pur,pyc,tpi
Bacillus_licheniformis	adk,ccpA,recF,rpoB,spo0A,sucC
Bacillus_subtilis	glpF,ilvD,pta,purH,pycA,rpoD,tpiA
Bacteroides_fragilis	dnaJ,fusA,groL,prfA,recA,rpoB,rprX
Bartonella_bacilliformis	ftsZ,flaA,ribC,rnpB,rpoB,bvrR,groEL
Bartonella_henselae	16S,batR,ftsZ,gltA,groEL,nlpD,ribC,rpoB
Bartonella_washoensis	16S,ftsZ,gltA,groEL,ribC,rpoB
Bordetella_spp.	adk,fumC,glyA,tyrB,icd,pepA,pgm
Borrelia_spp.	clpA,clpX,nifS,pepX,pyrG,recG,rplB,uvrA
Brachyspira_hampsonii	Bha_adh,Bha_est,Bha_gdh,Bha_glpK,Bha_pgm,Bha_thi
Brachyspira_hyodysenteriae	Bhy_adh,Bhy_alp,Bhy_est,Bhy_gdh,Bhy_glpK,Bhy_pgm,Bhy_thi
Brachyspira_intermedia	Bin_adh,Bin_alp,Bin_est,Bin_gdh,Bin_glpK,Bin_pgm,Bin_thi
Brachyspira_pilosicoli	Bpi_adh,Bpi_alp,Bpi_est,Bpi_gdh,Bpi_glpK,Bpi_pgm,Bpi_thi
Brachyspira_spp.	Bra_adh,Bra_alp,Bra_est,Bra_gdh,Bra_glp,Bra_pgm,Bra_thi
Brucella_spp.	gap,aroA,glk,dnaK,gyrB,trpE,cobQ,int_hyp,omp25
Burkholderia_cepacia_complex	atpD,gltB,gyrB,recA,lepA,phaC,trpB
Burkholderia_pseudomallei	ace,gltB,gmhD,lepA,lipA,narK,ndh
Campylobacter_concisus#curvus	Cco_aspA,Cco_atpA,Cco_glnA,Cco_gltA,Cco_glyA,Cco_ilvD,Cco_pgm
Campylobacter_fetus	Cfe_aspA,Cfe_glnA,Cfe_gltA,Cfe_glyA,Cfe_pgm,Cfe_tkt,Cfe_uncA
Campylobacter_helveticus	Che_aspA,Che_atpA,Che_glnA,Che_gltA,Che_glyA,Che_pgm,Che_tkt
Campylobacter_hyointestinalis	Chy_aspA,Chy_atpA,Chy_glnA,Chy_gltA,Chy_glyA,Chy_pgm,Chy_tkt
Campylobacter_insulaenigrae	Cin_aspA,Cin_atpA,Cin_glnA,Cin_glyA,Cin_pgi,Cin_pgm,Cin_tkt
Campylobacter_jejuni	aspA,glnA,gltA,glyA,pgm,tkt,uncA
Campylobacter_lanienae	Cln_aspA,Cln_atpA,Cln_glnA,Cln_gltA,Cln_glyA,Cln_pgm,Cln_tkt
Campylobacter_lari	Cla_adk,Cla_atpA,Cla_glnA,Cla_glyA,Cla_pgi,Cla_pgm,Cla_tkt
Campylobacter_sputorum	Csp_aspA,Csp_atpA,Csp_glnA,Csp_gltA,Csp_glyA,Csp_pgm,Csp_tkt
Campylobacter_upsaliensis	Cup_adk,Cup_aspA,Cup_atpA,Cup_glnA,Cup_glyA,Cup_pgi,Cup_tkt
Candida_albicans	AAT1a,ACC1,ADP1,MPIb,SYA1,VPS13,ZWF1b
Candida_glabrata	FKS,LEU2,NMT1,TRP1,UGP1,URA3
Candida_krusei	HIS3,LEU2,NMT1,TRP1,ADE2,LYS2D
Candida_tropicalis	ICL1,MDR1,SAPT2,SAPT4,XYR1,ZWF1a
Candidatus_Liberibacter_solanacearum	adk,atpA,fbpA,ftsZ,glyA,groEL,gyrB
Carnobacterium_maltaromaticum	dapE,ddlA,glpQ,ilvE,leuS,pyc,pyrE
Chlamydiales_spp.	gatA,oppA,hflX,gidA,enoA,hemN,fumC
Citrobacter_freundii	aspC,clpX,fadD,mdh,arcA,dnaG,lysP
Clonorchis_sinensis	Actin,Cox1,Cox3,Ef_1a,Its1,Nad4,Nad5,Tubulin
Clostridioides_difficile	adk,atpA,dxr,glyA,recA,sodA,tpi
Clostridium_botulinum	aroE,mdh,aceK,oppB,rpoB,recA,hsp
Clostridium_perfringens	colA,groEL,sodA,plc,gyrB,sigK,pgk,nadA
Clostridium_septicum	ddl,dnaK,glpK,groEL,gyrA,recA,tpi
Corynebacterium_diphtheriae	atpA,dnaE,dnaK,fusA,leuA,odhA,rpoB
Cronobacter_spp.	atpD,fusA,glnS,gltB,gyrB,infB,pps
Cutibacterium_acnes	aroE,atpD,gmk,guaA,lepA,sodA,tly,CAMP2
Dichelobacter_nodosus	dcd,dtdA,folK,recR,rlmH,rplI,tsaE
Edwardsiella_spp.	adk,atpD,dnaJ,gapA,glnA,hsp60,phoR,pyrG,rpoA,tuf
Enterobacter_cloacae	dnaA,fusA,gyrB,leuS,pyrG,rplB,rpoB
Enterococcus_faecalis	gdh,gyd,pstS,gki,aroE,xpt,yqiL
Enterococcus_faecium	atpA,ddl,gdh,purK,gyd,pstS,adk
Escherichia_coli#1	adk,fumC,gyrB,icd,mdh,purA,recA
Escherichia_coli#2	dinB,icdA,pabB,polB,putP,trpA,trpB,uidA
Flavobacterium_psychrophilum	atpA,dnaK,fumC,gyrB,murG,trpB,tuf
Gallibacterium_anatis	adk,atpD,fumC,gyrB,infB,mdh,recN,thdF
Geotrichum_spp.	NUP116,URA1,URA3,SAPT4,PLB3
Glaesserella_parasuis	atpD,infB,mdh,rpoB,6pgd,g3pd,frdB
Haemophilus_influenzae	adk,atpG,frdB,fucK,mdh,pgi,recA
Helicobacter_cinaedi	23S_rRNA,ppa,aspA,aroE,atpA,tkt,cdtB
Helicobacter_pylori	atpA,efp,mutY,ppa,trpC,ureI,yphC
Helicobacter_suis	atpA,efp,mutY,ppa,trpC,ureAB,yphC
Kingella_kingae	abcZ,adk,aroE,cpn60,gdh,recA
Klebsiella_aerogenes	dnaA,fusA,gyrB,leuS,pryG,rplB,rpoB
Klebsiella_oxytoca	gapA,infB,mdh,pgi,phoE,rpoB,tonB
Klebsiella_pneumoniae	gapA,infB,mdh,pgi,phoE,rpoB,tonB
Kudoa_septempunctata	cox1,rnl
Lactobacillus_salivarius	pstB,rpsB,nrdB,rpoA,parB
Lactococcus_lactis_bacteriophage	terL,mcp,mtp,tmp,lys
Leptospira_spp.	glmU_1,pntA_1,sucA_1,tpiA_1,pfkB_1,mreA_1,caiB_1
Leptospira_spp.#2	adk_2,glmU_2,icdA_2,lipL32_2,lipL41_2,mreA_2,pntA_2
Leptospira_spp.#3	adk_3,icdA_3,lipL41_3,rrs2_3,secY_3,lipL32_3
Listeria_monocytogenes	abcZ,bglA,cat,dapE,dat,ldh,lhkA
Macrococcus_canis	ack,cpn60,fdh,pta,purA,sar,tuf
Macrococcus_caseolyticus	ack,cpn60,fdh,pta,purA,sar,tuf
Mammaliicoccus_sciuri	ack,aroE,ftsZ,glpK,gmk,pta1,tpiA
Mannheimia_haemolytica	adk,aroE,deoD,gapDH,gnd,mdh,zwf
Melissococcus_plutonius	argE,galK,gbpB,purR
Moraxella_catarrhalis	abcZ,adk,efp,fumC,glyBeta,mutY,ppa,trpE
Mycobacteria_spp.	S14Z,L35,S19,L19,S12,S8,L16,S7
Mycobacteroides_abscessus	argH,cya,gnd,murC,pta,purH,rpoB
Mycoplasma_agalactiae	dnaA,gltX,gyrB,metS,tufA
Mycoplasma_anserisalpingitidis	atpG,fusA,pgiB,plsY,uvrA
Mycoplasma_bovis	dnaA,gltX,gpsA,gyrB,pta2,tdk,tkt
Mycoplasma_flocculare	adk,rpoB,tpiA
Mycoplasma_gallisepticum#1	atpG,dppC,DUF3196,lgT,mraW,plsC,ugpA
Mycoplasma_gallisepticum#2	atpG2,dnaA,fusA,rpoB,ruvB,uvrA
Mycoplasma_hominis	uvrA,gyrB,ftsY,tuf,gap
Mycoplasma_hyopneumoniae	adk,rpoB,tpiA
Mycoplasma_hyorhinis	dnaA,rpoB,gyrB,gltX,adk,gmk
Mycoplasma_iowae	dppC,ulaA,valS,rpoC,leuS,kdpA
Mycoplasma_pneumoniae	ppa,pgm,gyrB,gmk,glyA,atpA,arcC,adk
Mycoplasma_synoviae	adk,atpG,efp,gmk,nagC,ppa,recA
Neisseria_spp.	abcZ,adk,aroE,fumC,gdh,pdhC,pgm
Orientia_tsutsugamushi	gpsA,mdh,nrdB,nuoF,ppdK,sucB,sucD
Ornithobacterium_rhinotracheale	adk,aroE,fumC,gdhA,mdh,pgi,pmi
Paenibacillus_larvae	glpF,sigF,glpT,Natrans,rpoB,ftsA,clpC
Pasteurella_multocida#1	RIRDC_adk,RIRDC_est,RIRDC_pmi,RIRDC_zwf,RIRDC_mdh,RIRDC_gdh,RIRDC_pgi
Pasteurella_multocida#2	mh_adk,mh_aroA,mh_deoD,mh_gdhA,mh_g6pd,mh_mdh,mh_pgi
Pediococcus_pentosaceus	gyrB,pyc,pgm,leuS,glnA,dalR,pgI
Photobacterium_damselae	glpF,gyrB,metG,pntA,pyrC,toxR
Piscirickettsia_salmonis	dnaK,efp,fumC,glyA,murG,rpoD,trpB
Porphyromonas_gingivalis	ftsQ,gpdxJ,hagB,mcmA,pepO,pga,recA
Pseudomonas_aeruginosa	acsA,aroE,guaA,mutL,nuoD,ppsA,trpE
Pseudomonas_fluorescens	glnS,gyrB,ileS,nuoD,recA,rpoB,rpoD
Pseudomonas_putida	argS,gyrB,ileS,nuoC,ppsA,recA,rpoB,rpoD
Rhodococcus_spp.	gapdh,tpi,mdh,icl,rpoB,recA,adk
Riemerella_anatipestifer	dnaB,groEL,gyrA,mdh,gluD,gpi,rpoB
Salmonella_enterica	aroC,dnaN,hemD,hisD,purE,sucA,thrA
Saprolegnia_parasitica	ALTS1,COX1,GLUT,NAD1,RPB2,SHMT,TUBB
Shewanella_spp.	16S_rRNA,adk,atpB,guaA,gyrB,mdh,recA,rpoS
Sinorhizobium_spp.	asd,edd,gap,glnD,gnd,nuoE1,ordL2,recA,sucA,zwf
Staphylococcus_aureus	arcC,aroE,glpF,gmk,pta,tpi,yqiL
Staphylococcus_chromogenes	arcC,hutU,fumC,dnaJ,glpF,menF,pta
Staphylococcus_epidermidis	arcC,aroE,gtr,mutS,pyrR,tpiA,yqiL
Staphylococcus_haemolyticus	arcC,SH_1200,hemH,leuB,SH1431,cfxE,Ribose_ABC
Staphylococcus_hominis	arcC,glpK,gtr,pta,tpiA,tuf
Staphylococcus_lugdunensis	aroE,dat,ddl,gmk,ldh,recA,yqiL
Staphylococcus_pseudintermedius	ack,cpn60,fdh,pta,purA,sar,tuf
Stenotrophomonas_maltophilia	atpD,gapA,guaA,mutM,nuoD,ppsA,recA
Streptococcus_agalactiae	adhP,pheS,atr,glnA,sdhA,glcK,tkt
Streptococcus_bovis#equinus_complex__SBSEC_	ddl,gki,glnA,mutS,mutS2,pheS,proS,pyrE,thrS,tpi
Streptococcus_canis	gki,gtr,murI,mutS,recP,xpt,yqiZ
Streptococcus_dysgalactiae_equisimilis	gki,gtr,murI,mutS,recP,xpt,atoB
Streptococcus_gallolyticus	aroE,glgB,nifS,p20,tkt,trpD,uvrA
Streptococcus_oralis	aroE,ddl,gdh,gki,hexB,recP,xpt
Streptococcus_pneumoniae	aroE,gdh,gki,recP,spi,xpt,ddl
Streptococcus_pyogenes	gki,gtr,murI,mutS,recP,xpt,yqiL
Streptococcus_suis	aroA,cpn60,dpr,gki,mutS,recA,thrA
Streptococcus_thermophilus	ddlA,glcK,proA,ptsI,serB,tkt
Streptococcus_thermophilus#2	carB,clpX,dnaA,murC,murE,pepN,pepX,pyrG,recA,rpoB
Streptococcus_uberis	arcC,ddl,gki,recP,tdk,tpi,yqiL
Streptococcus_zooepidemicus	arcC,nrdE,proS,spi,tdk,tpi,yqiL
Streptomyces_spp	16S,atpD,gyrB,recA,rpoB,trpB
Taylorella_spp.	gltA,gyrB,fh,shmt,tyrB,adk,txn
Tenacibaculum_spp.	atpA,dnaK,glyA,gyrB,infB,rlmN,tgt
Treponema_pallidum	TP0136,TP0548,TP0705
Trichomonas_vaginalis	TRYP,GLUT,FT2A,ALTS,DMRP,SHMT,M6PI
Ureaplasma_spp.	ftsH,rpL22,thrS,valS
Vibrio_cholerae	adk,gyrB,mdh,metE,pntA,purM,pyrC
Vibrio_cholerae#2	asd,dnaE,lap,pgm,recA
Vibrio_parahaemolyticus	dnaE,gyrB,recA,dtdS,pntA,pyrC,tnaA
Vibrio_spp.	gyrB,pyrH,recA,atpA
Vibrio_tapetis	atpA,fstZ,gapA,hsp60,pyrH,rctB,recA,rpoA,rpoD,topA
Vibrio_vulnificus	glp,gyrB,mdh,metG,purM,dtdS,lysA,pntA,pyrC,tnaA
Wolbachia	gatB,coxA,hcpA,ftsZ,fbpA
Xylella_fastidiosa	leuA,petC,malF,cysG,holC,nuoL,gltT
Yersinia_pseudotuberculosis	adk,argA,aroA,glnA,thrA,tmk,trpE
Yersinia_ruckeri	glnA,gyrB,dnaJ,thrA,hsp60,recA
